{
  "0": "06",
  "1": "12",
  "2": "15",
  "3": "19",
  "4": "20",
  "5": "27",
  "6": "28",
  "7": "29",
  "8": "30",
  "9": "31",
  "10": "34",
  "11": "36",
  "12": "37",
  "13": "38",
  "14": "39",
  "15": "41",
  "16": "44",
  "17": "45",
  "18": "47",
  "19": "49",
  "20": "50",
  "21": "52",
  "22": "53",
  "23": "55",
  "24": "60",
  "25": "61",
  "26": "62",
  "27": "64",
  "28": "65",
  "29": "66",
  "30": "67",
  "31": "68",
  "32": "69",
  "33": "70",
  "34": "73",
  "35": "75",
  "36": "76",
  "37": "81",
  "38": "82",
  "39": "87",
  "40": "89",
  "41": "90"
}